#####################################################################################################
A       #           #   #   # # # #       #   #   # #       #         #           #   # #     #     #
# ##### # ### ##### # ### ### # # # ### ##### ### # # # ####### # ### ### ####### # ### # ### # # ###
# #   #     # # #     #   #   #     #       #       # #         # # #   # # #   #           # # # # #
# # ######### # # ### # ### ####### # # ########### ####### ### ### ####### # ### ##### # ##### # # #
#         # #   # #     #     #     # #     # #   #           # #   #     #           # # # # # #   #
### ##### # # ### ##### # # ##### ### # # # # # ### ##### # ### # ##### ##### # ##### ### # # ##### #
# #   #   #     # # #     #     # # # # # # #         #   # #     #   #   #   #   #   #             #
# # ### ### ##### # ######### # # # # # # ####### # ############# # # # ####### ### # ######### ### #
#     # #     #         #   # #   #   # # #       #     #   #       # #           # #   #         # #
# ############# ####### # # # ### # # ####### ####### ### ####### ####### ### ######### # # # ### ###
#       # #       #   # # # # #   # # #         #   # # # # #     #   #   # # #   #   # # # # #     #
### ### # ### ####### ##### ### ### ######### # ### ### # # # # ### # # # # ### ##### # ########### #
#     #     #   #       #     #   # #         #         # #   #     # # # #     #             #     #
### ######### # # ##### ##### ### # ### # # # ####### # # ### ### ### ####### ### # ##### ######### #
# #     # #   # #     # #         #     # # #   #   # # #   #   # #           #   #     #     # # # #
# ### ### ##### ####### # # # # ####### ### ##### ##### # # # ### ##### ##### # # # ########### # # #
#           #           # # # # #       #   #   # #   # # # # # #     # # # #   # # #           #   #
# # # ####### ####### ####### # # ##### ####### # ### # # # # # # ####### # ### ##### ### # # ##### #
# # #     #       #       #   # #   #           #         # # #           #           #   # #   #   B
##################################################################################################### 